RRRRRRRRRRRRRRRRRRRRRRRRR
R     R     R     R     R
R     R     R     R     R
R     R     R     R     R
R     R     R     R     R
R     R     R G   R     R
RRRRRRRRRRRRRRRRXXRRRRRRR
R     R     R     R     R
R     R     R     R     R
R     R     R     R     R
R     R     R     R     R
R     R     R     R     R
RRRRRRRRRRRRRRRRRRRRRRRRR
R     R     R     R     R
R     R     R     R     R
R     R     R     R     R
R     R     R     R     R
R     R     R     R     R
RRRRRRRRRRRRRRRRRRRRRRRRR
R     R     R     R P   R
R     R     R     R     R
R     R     R     R     R
R     R     R     R     R
R     R     R     R     R
ARRRRRRRRRRRRRRRRRRRRRRRR