RRRRRRRRRRRRRRRRRRRRRRRRR
R     R     R     R     R
R     R     R     R     R
R     R     R     R     R
R     R     R     R     R
R     R     R     R     R
RRRRRRRRRRRRRRRRRRRRRRRRR
R     R     RG    R     R
R     R     R     R     R
R     R     R     R     R
R     R     R     R     R
R     R     R     R     R
RRRRRRRRRRRRRRRRRRRRRRRRR
R     R     R     R     R
R     R     R     R     R
R     R     R     R     R
R     R     R     R     R
R     R     R     R     R
RRRRRRRRRRRRRRRRRRRRRRRRR
R     R     R     R     R
R     R     R     R     R
R     R     R     R     R
R     R     R     R     R
R     R     R     R     R
ARRRRRRRRRRRRRRRRRRRRRRRR